wwwwwwwwwwwwwwwwwwwwwwwwwwwwwwww
w                              w
w                w             w
w          w                   w
w                              w
w     w      s                 w
w                              w
w                              w
w                              w
w                         w    w
w   w                          w
w    w                         w
w                     wwww     w
w   w                          w
w                 w            w
w   w        w                 w
w                              w
wwwwwwwwwwwwwwwwwwwwwwwwwwwwwwww
