wwwwwwwwwwwwwwwwwwwwwwwwwwwwwwww
w                              w
w  w   w         w   wwww      w
w      w   w            w      w
w      ww           w          w
w     w      www    ww         w
w              wwww            w
w                 w            w
w                              w
w          w   s          w    w
w   ww     ww                  w
w    w      w                  w
w           w         wwww     w
w   w                          w
w   w             w    ww  w   w
w   w        wwww      ww   w  w
w                              w
wwwwwwwwwwwwwwwwwwwwwwwwwwwwwwww
